8 8
GGGG GGGG GGGG GGGG GGGG GGGG GGGG GGGG
GGGG GGGG GGGG GGYY GGYY GGGG GGGG GGGG
RRRR RRRR RRRR RYYY YYYY MMMM MMMM MMMM
RRRR RRRR RRRR YYYY YYYY MMMM MMMM MMMM
RRRR RRRR RRRR YYYY YYYY MMMM MMMM MMMM
RRRR RRRR RRRR YYYY YYYM MMMM MMMM MMMM
GGGG GGGG GGGG YYGG YYGG GGGG GGGG GGGG
GGGG GGGG GGGG GGGG GGGG GGGG GGGG GGGG

player 0 0
timer 45
cent 1 0
dollar 6 1
wgate 3 2
diamond 0 3
wlever 7 3
rgate 4 5
rlever 7 0
thief 7 5 m w
ruby 1 6
door 3 7 
flyingassassin 4 7 n
clock 6 7
bomb 7 7