2
10 10
YYYY YYYY YYYY YYYY YGYY GGYG GGGG GGGG MMMM GGGG
MMMM MMMM YYYY YYYY YYYY GGGG GGGG GGGG MMMM GGGG
YYYY MMMM YYYY YYYY YYYY GGGG GGGG GGGG MMMM GGGG
YYYY YYYY YYYY YYYY YYYY GGGG GGGG GGGG GGGG GGGG
YYYY YYYY YYYY YYYY MMMM GGRR MMMM MMMM MMMM MMMM
BBBB BBBB BBBB BBBB MMMM MMRR MMMM MMMM MMMM MMMM
MMMM MMMM BBBB BBBB BRBB RRBR RRRR RRRR RRRR RRRR
MMMM MMMM BBBB BBBB BBBB RRRR RRRR RRRR RRRR RRRR
BBBB BBBB BBBB BBBB BBBB RRRR RRRR RRRR RRRR RRRR
BBBB BBBB BBBB MMMM MMMM MMMM RRRR RRRR RRRR RRRR

player 0 0
timer 50
door 4 9
bomb 3 8
clock 2 7
dollar 6 1
dollar 3 4
diamond 4 4 
ruby 0 2
cent 8 6
cent 9 3
cent 6 8
flyingassassin 0 3 e
thief 9 9 r w
rlever 0 5
rgate 5 5
wlever 9 0
wgate 5 4